drr
40
###############
# o           #
#     AA      #
#             #
#          x  #
###############
