
100
##########
#o      x#
#A     X #
#        #
#        #
#A   + X #
##########
