
100
#########
#o  <  x#
#   <   #
#   <   #
#   <   #
#   >   #
#########
