
100
#########
#o<    x#
#>v  e  #
#       #
#       #
#       #
#########
