
100
#######
#o    #
##### #
#     #
#     #
# #####
#     #
##### #
#x    #
#######
