
200
#######################
# o   A C V       e   #
# +   e################
# +    ################
# +    XX             #
# +      Y            #
# +  A         Y      #
# +    +++<+v     a   #
# ++++++++>+++CV     x#
#######################
