
100
#########
#oAx    #
#       #
#       #
#       #
#    A  #
#########
