
100
##########
#o<     x#
#<       #
#        #
#        #
#        #
##########
