
100
#########
#o  <  x#
#   <   #
#   <   #
#   <   #
#   v   #
#########
