rdurrrrrrrrrrrrurrdrrrrruullddd
200
#######################
# o   A C V           #
# +e   ################
# +    ################
# +    XX             #
# +      Y            #
# +  A         Y   e  #
# +    +++<+v         #
# ++++++++>+++   C V x#
#######################
